13
7
....^........
S...^........
....^........
ooooo........
sssss........
.............
G............